00000000000000000000000000000000000000000000000000000000000000000000000000000000000000000000000000000000000000000000000000000000
00000000000000000000000000000000000000000000000000000000000000000000000000000000000000000000000000000000000000000000000000000000
00000000000000000000000000000000000000000000000000000000000000000000000000000000000000000000000000000000000000000000000000000000
00000000000000000000000000000000000000000000000000000000000000000000000000000000000000000000000000000000000000000000000000000000
00000000000000000000000000000000000000000000000000000000000000000000000000000000000000000000000000000000000000000000000000000000
00000000000000000000000000000000000000000000000000000000000000000000000000000000000000000000000000000000000000000000000000000000
00000000000000000000000000000000000000000000000000000000000000000000000000000000000000000000000000000000000000000000000000000000
00000000000000000000000000000000000000000000000000000000000000000000000000000000000000000000000000000000000000000000000000000000
00000000000000000000000000000000000000000000000000000000000000000000000000000000000000000000000000000000000000000000000000000000
00000000000000000000000000000000000000000000000000000000000000000000000000000000000000000000000000000000000000000000000000000000
00000000000000000000000000000000000000000000000000000000000000000000000000000000000000000000000000000000000000000000000000000000
00000000000000000000000000000000000000000000000000000000000000000000000000000000000000000000000000000000000000000000000000000000
00000000000000000000000000000000000000000000000000000000000000000000000000000000000000000000000000000000000000000000000000000000
00000000000000000000000000000000000000000000000000000000000000000000000000000000000000000000000000000000000000000000000000000000
00000000000000000000000000000000000000000000000000000000000000000000000000000000000000000000000000000000000000000000000000000000
00000000000000000000000000000000000000000000000000000000000000000000000000000000000000000000000000000000000000000000000000000000
00000000000000000000000000000000000000000000000000000000000000000000000000000000000000000000000000000000000000000000000000000000
00000000000000000000000000000000000000000000000000000000000000000000000000000000000000000000000000000000000000000000000000000000
00000000000000000000000000000000000000000000000000000000000000000000000000000000000000000000000000000000000000000000000000000000
00000000000000000000000000000000000000000000101000000000000000000000000000000000000000000000000000000000000000000000000000000000
00000000000000000000000000000000000000001010101010100000000000000000000000000000000000000000000000000000000000000000000000000000
00000000000000000000000000000000000010101010001010101010000000000000000000000000000000000000000000000000101000000000000000000000
00000000000000000000000000000000101010101010001010101010101000000000000000000000000000000000000000001010101010100000000000000000
00000000000000000000000000000000000000000000001000000000000000000000000000000000000000000000000010101010001010101010000000000000
00000000000000000000000000000000000000000000001000000000000000000000000000000000000000000000101010101010001010101010101000000000
00000000000000000000000000000000000000000000001000000000000000000000000000000000000000000000000000000000001000000000000010000000
00000000000000000000000000000000100010000000100010000000000000000000000000001000100010001000000000000000001000000000000001001000
00000000000000000000000000000000010001001000010001001000000000000000100010000100010001000100100010000000001010001000100001000100
00000000000000000000000000001000010001000100010001000100000000000000010001000100001100110100010001001000100001000100010001000100
00000000000000000000000000000100010001000100010001000100100010001000010001000011001100110100010001000100010001000100010000110100
10001000100010001000100010000100010001000100010001000100010001000100010001000011001100110100010000110100010001000100010000110100
01000100010001000100010001000011010000110100001100110100010001000100010000110011001100110100010000110100010001000100001100110011
01000011010001000100010000110011001100110011100100110011001100110100010000110011001100110011010000110100010001000011001100110011
01000011010001000100010000110011100110110011001100110011001100110100001110110011001100110011001100110100001100110011001100111011
01000011010000110100010000110011001110010011001100110011001100110011001110110011101110110011001100110011001110011001101110110011
01000011001100110011001100110011001100110011001110011001001100111001100100111011001100110011001100110011001100111001001100110011
00110011001100110011001100110011001100110011001100110011001100110011100100110011001100110011001100111011001110111011001100110011
00110011001100110011001100110011101100110011001100111011001100110011001100110011001100110011001100110011001100110011001100110011
00110011100100110011001100110011101100110011001100110011001100110011001100110011001100110011001100110011001100110011001110111001
00110011001100110011001110011001100110010011001100110011001100110011001100110011001110111011101110010011001110011011001100110011
10110011001110010011001100110011100110011011001100111011001100110011001100110011001100110011101100110011001100110011001100111011
00110011001100110011001100110011001100110011001110110011001100110011001100110011001100110011001100110011101100111011001100110011
00110011001100110011100100110011001100110011001100110011001100110011001110110011001100110011001100110011101110011011101100110011
00110011001100111001001100110011001100110011001100110011001100110011101100110011001100110011001100110011001100110011101100110011
00110011001100110011001100110011001100110011001100110011001100110011101100110011001100110011001100110011001100111011101100110011
00110011001100110011001100110011001100110011001100110011001110010011001110110011101110110011001100110011001100110011001100110011
00110011001100110011001100110011001100110011001100110011001100110011001110110011001110110011001100110011001100110011001100110011
00110011001100110011001100110011001100110011001100110011001100110011001100110011001100111001001100110011001100110011001100111001
00110011001100110011001100110011100110010011001100110011001100110011001100110011001101110111001100110011001100110011001100110011
00111001001100110011001100110011001110110011101100110011001100110011001100110011001100111001100100110011001100110011001100110011
00110011101101110111001100110011100101110011001100110011001100110011001100110011001100110011100100111001100100110011001100110011
00110111101100110011001100110011001110010011001100110011001100110011001100110011001100110011001100110011101100110011001100110011
00110111001100111001001110011001001100110011001100110011001100110011101100110011001100110011001110110011001100110011001100110011
00110011100110010011001100110011001100110011001100110011001100110011101100110011101100110011001110010011001100110011001100110011
10111011001100110011101110110011001110110011101100110011101110110011001100110011101100110011001100110011001100110011001110010011
00111011001100110011001100110011011100110011101100110011001110110011001101110011001101110011001110111011001100110011001100110011
00110011001101010011001100110011001100110011001100110011001100110011001100110101010100110011001101010011001100110011001100110011
00110101001101010111001100110011001100110011101100110011001100110011001100110011010100110011001101010101101100110011001100110011
01110111001100110011001100110011001100110011101100110011001100110011001100111001001101110011001101110101001100110011001100110011
00110011001100110101101100110011101100110011101100111011001100110011001100110011001100110011001100110011001100110011010101011011
00111011001100110011101100110011101100111011100100110011001110111011101100110011001110111011001100110011001100111001001101111011
01110011001100110011001100110011001100111011001100110011001110111001001100110011001100110011001100110011001100110011001100110111
00110011001100110011001100110011001100110011001100110011001100110011001100110011001100110011001100110011001100110011001100110011
00010001000100010001000100010001000100010001000100010001000100010001000100010001000100010001000100010001000100010001000100010001
