512'h00000000000000000000000000000000000000000000000000000000000000000000000000000000000000000000000000000000000000000000000000000000,
512'h00000000000000000000000000000000000000000000000000000000000000000000000000000000000000000000000000000000000000000000000000000000,
512'h00000000000000000000000000000000000000000000000000000000000000000000000000000000000000000000000000000000000000000000000000000000,
512'h00000000000000000000000000000000000000000000000000000000000000000000000000000000000000000000000000000000000000000000000000000000,
512'h00000000000000000000000000000000000000000000000000000000000000000000000000000000000000000000000000000000000000000000000000000000,
512'h00000000000000000000000000000000000000000000000000000000000000000000000000000000000000000000000000000000000000000000000000000000,
512'h00000000000000000000000000000000000000000000000000000000000000000000000000000000000000000000000000000000000000000000000000000000,
512'h00000000000000000000000000000000000000000000000000000000000000000000000000000000000000000000000000000000000000000000000000000000,
512'h00000000000000000000000000000000000000000000000000000000000000000000000000000000000000000000000000000000000000000000000000000000,
512'h00000000000000000000000000000000000000000000000000000000000000000000000000000000000000000000000000000000000000000000000000000000,
512'h00000000000000000000000000000000000000000000000000000000000000000000000000000000000000000000000000000000000000000000000000000000,
512'h00000000000000000000000000000000000000000000000000000000000000000000000000000000000000000000000000000000000000000000000000000000,
512'h00000000000000000000000000000000000000000000000000000000000000000000000000000000000000000000000000000000000000000000000000000000,
512'h00000000000000000000000000000000000000000000000000000000000000000000000000000000000000000000000000000000000000000000000000000000,
512'h00000000000000000000000000000000000000000000000000000000000000000000000000000000000000000000000000000000000000000000000000000000,
512'h00000000000000000000000000000000000000000000000000000000000000000000000000000000000000000000000000000000000000000000000000000000,
512'h00000000000000000000000000000000000000000000000000000000000000000000000000000000000000000000000000000000000000000000000000000000,
512'h00000000000000000000000000000000000000000000000000000000000000000000000000000000000000000000000000000000000000000000000000000000,
512'h00000000000000000000000000000000000000000000000000000000000000000000000000000000000000000000000000000000000000000000000000000000,
512'h00000000000000000000000000000000000000000000000000000000000000000000000000000000000000000000000000000000000000000000000000000000,
512'h00000000000000000000000000000000000000000000000000000000000000000000000000000000000000000000000000000000000000000000000000000000,
512'h00000000000000000000000000000000000000000000000000000000000000000000000000000000000000000000000000000000000000000000000000000000,
512'h00000000000000000000000000000000000000000000000000000000000000000000000000000000000000000000000000000000000000000000000000000000,
512'h00000000000000000000000000000000000000000000000000000000000000000000000000000000000000000000000000000000000000000000000000000000,
512'h00000000000000000000000000000000000000000000000000000000000000000000000000000000000000000000000000000000000000000000000000000000,
512'h00000000000000000000000000000000000000000000000000000000000000000000000000000000000000000000000000000000000000000000000000000000,
512'h00000000000000000000000000000000000000000000000000000000000000000000000000000000000000000000000000000000000000000000000000000000,
512'h00000000000000000000000000000000000000000000000000000000000000000000000000000000000000000000000000000000000000000000000000000000,
512'h00000000000000000000000000000000000000000000000000000000000000000000000000000000000000000000000000000000000000000000000000000000,
512'h00000000000000000000000000000000000000000000000000000000000000000000000000000000000000000000000000000000000000000000000000000000,
512'h00000000000000000000000000000000000000000000000000000000000000000000000000000000000000000000000000000000000000000000000000000000,
512'h00000000000000000000000000000000000000000000000000000000000000000000000000000000000000000000000000000000000000000000000000000000,
512'h00000000000000000000000000000000000000000000000000000000000000000000000000000000000000000000000000000000000000000000000000000000,
512'h00000000000000000000000000000000000000000000000000000000000000000000000000000000000000000000000000000000000000000000000000000000,
512'h00000000000000000000000000000000000000000000000000000000000000000000000000000000000000000000000000000000000000000000000000000000,
512'h00000000000000000000000000000000000000000000000000000000000000000000000000000000000000000000000000000000000000000000000000000000,
512'h00000000000000000000000000000000000000000000000000000000000000000000000000000000000000000000000000000000000000000000000000000000,
512'h00000000000000000000000000000000000000000000000000000000000000000000000000000000000000000000000000000000000000000000000000000000,
512'h00000000000000000000000000000000000000000000000000000000000000000000000000000000000000000000000000000000000000000000000000000000,
512'h00000000000000000000000000000000000000000000000000000000000000000000000000000000000000000000000000000000000000000000000000000000,
512'h00000000000000000000000000000000000000000000000000000000000000000000000000000000000000000000000000000000000000000000000000000000,
512'h00000000000000000000000000000000000000000000000000000000000000000000000000000000000000000000000000000000000000000000000000000000,
512'h00000000000000000000000000000000000000000000000000000000000000000000000000000000000000000000000000000000000000000000000000000000,
512'h00000000000000000000000000000000000000000000000000000000000000000000000000000000000000000000000000000000000000000000000000000000,
512'h00000000000000000000000000000000000000000000000000000000000000000000000000000000000000000000000000000000000000000000000000000000,
512'h00000000000000000000000000000000000000000000000000000000000000000000000000000000000000000000000000000000000000000000000000000000,
512'h00000000000000000000000000000000000000000000000000000000000000000000000000000000000000000000000000000000000000000000000000000000,
512'h000000000000000000000000000000000000000000000000000000000000000000A0000000000000000000000000000000000000000000000000000000000000,
512'h00000000000000000000000000000000000000000000000000000000000000000AAA000000000000000000000000000000000000000000000000000000000000,
512'h0000000000000000000000000000000000000000000000000000000000000000AAEAA00000000000000000000000000000000000000000000000000000000000,
512'h800000000000000000000000000000000000000000000000008000000000000AAAEAAA0000000000000000000000000000000000000000000000000000000000,
512'hC8000000000000000000000000000000000000000000000880C800000000000000E0000000000000000000000000000000000000000000000000000000000000,
512'hCC880000000000000080000000000000000000008880088CC8BC00000008880000E0000000000000000000000000000000000000000000000000000000000000,
512'hCCCC00000000000000C800008888888888088888CCC80CCBCCBC8888088CCC0000E0000000000000000000000000000000000000000000000000000000000000,
512'hCBBB80000000000008BC8808CCCCCCCCCC8CCCCCCCCC8BBBCCBCCCCC8CCCCC800080000000000000000000000000000000000000000000000000000000000000,
512'hCBBBC888888880088CBCCC8CCCCBBCCCCBCCCCCCCCCCCBBBBCBCCCCBCCCCCBC888C0000800000000000000000000000000000000000000000000000000000000,
512'hBBBBCCCCCCCCC88CCCBCCBCCCCCBBCCCCBCCBCCCCBCBCBBBBBBBCCCBCCCBCBBCCCC8088C00000000000000000000000000000000000000000000000000000000,
512'hBBBBBBCCCBCBCCCCBCBCCBCBBCBBBCCCCBCBBCBCBBBBCBBBBBBBBBCBCBBBBBBCCCCC8CCB80000000000000000000000000000000000000000000000000000000,
512'hBBBBBBCCBBBBCCCCBCBCCBCBBCBBBCCBCBCBBCBCB3BBBBBBBBBBBBCBCBBBBBBCCCCCCCCBC8888888000000000000000000000000000000000000000000000000,
512'hBBBBBBCCBBBBBBBCBBB3BBBBBBBBBBBBBBCBBBBBBBBBBBBBBBBBBBBBBBBBBBBCCCCCCCCBCCCCCCCC000000000000000000000000000000000000000000000000,
512'hBBB7BBBBBBBBBBBCBBBBBBBBBBBBBBBBBBBBBBBBBB7BB3BBBBBBBBBBBBBBBBBCBCBCCBCBCCCCCCCB888800000000000000000000000000000000000000000000,
512'hBBBBBBBBBBBBBBBBBBB9BBBB9BBBB9BBBBBBBBB9BBB7BB7BBBBBBBBBBBBBBB93BBBCCBBBBBCCCCCBCCCC880000000000000000A0000000000000000000000000,
512'hB3B3BB3BBB3BBBBBB3BBB9BBBBBBBBBBBBBBBBBBBBBBBBBB3BBBB7BB9B3B3BBBBBBBBBB9BBBCCBCBBCCCCC000000000000000AAA000000000000000000000000,
512'hBBBBBB3BBBBBB9BBBBBB3BBBBBBBBBBB3BBBB33BBBBBB3BBBB3BBBBBBB9BBBBBBBBBBBBBBBBBBBCBBBCBCC88000000000000AAEAA00000000000000000000000,
512'h99B7BBBBBBBB7BBBBBBBBBBB79BBBBBBBBBBBBBBBBBBBB3BBB3BBBBBBBBBBBBBBBBBBBBBBBBBBBBBBBBBCCCC00000000000AAAEAAA0000000000000000000000,
512'h9BBBBBBBB3BBBBBBBB3B3BBBB7BBBBB73BBB9B7BBBBBBBBBBBBBBBBBBBB3B3BBBBBB9BB7BBB3BBBBBBBBBCCC80000000000000E0000000000000000000000000,
512'hBBBBBBBBBBBBBBBBB3BBBBBBBB7BB3BBBB3BBBBBBBB7BBB3BBBBBB3B9BBBBBBBBBBBBBBBBBB7BBBBBBB9BCCCC8888000000000E8080000000000000000000008,
512'hBBBBBBBBBBBBBB9BBBBB3BBBB3BBBBBBBBBBBBBBB7BBBBBBBB9BBBBBBBBBBBBBBBBBBBBBBBBBBBB3B9B3BBCBCCCCC800000000EC8C800088800000000000008C,
512'hBBB3BBBBBB3BBBBBBBB39BB7BBBB39BBBBBBBBBBBB7BB7BBBBBBBBBBBBB7BBBBBBBBBBB7BBBBB93BB3BBBBCBCBCCCC000000888CCCC888CCC8000000000088CB,
512'h7BBBBBBBBBBBBBBBBB3BBBBBBBBBBBBBBBB3BBBBB3BB7BBBBB7BBBBBBB7BBBBBBBBBB3B7BBB33BBBBBBBBBBBCBCCCB888008CCCCCCCCCCBCBC8088888880CCCB,
512'h9BBBBBBBBBBBBBBB3BBB9B9BBBBBBBBBBBBB3BBBB3BBBBBBBBBBBBBBBBBBBBBB7BBBBBBBBBBB7BBBBBBBB9BBCBCCBBCCC88CCCCCCCBBCBBCBBC8CCCCCCC8CCCB,
512'hBBBBBB3BBBBB97BBBBBBBBBB3BBBBBBBBBBB9BBBBBBBB373BBBBBBBBBBBBBB3BBBBBBBBBBBB33BBB9BBBBBBBBBCBBBCCCCCCCCCBBBBBCBBBBBBCCCCCCCCCBCBB,
512'hBBBBBBBBBBBB7BBBBBBBBBBBBBB3B3BB3BBBBBBBBBBBBBBBBBBB3B7B3BBBBB3BBBBBBBBBBBBBBBBBBB3BBBBBBBBBBBCCCCCCCBBBBBBBCBBBBBBCCCCBCBBCBBBB,
512'hBBBBBBBBBBBBBBBBBBB7BBBBBBBBBBB9BBBBBBB9B39BBBBBBB3BBBBBBBBBBBBBBBBBBBB79BBBBBBB3BBBBBBB7BBB9BBBCCCBBBBBBB3BCBBBBBBCBBCBCBBCBBBB,
512'hBB9BBBBBBBBBBBBBBBBBBBBBBBBBBBBBBB3BBBB7BBBBBB9B9BBBBB79BB33BBBBBBBBBBBBBBBBBB7BBBB3BBBBBBBBBBBBCCCBBB7BBBBBB3BBBBBBBBBBCBBCBB9B,
512'h9BBBBBBBBBBB3B7BB3BBBB3BBBBBBBBBBBBBBBBBBBBBBB9BBBBBB7BBBBBB3BBBBB3BBBBB3BBBBBBBBBBBBBBBBB7BBBBBBCCBBBBBBBBBBBBBBBBBBBBBBBBBBBB9,
512'hBBBBBBBBBBBBBBBBBBBBBBBBBBBB3BBBB3BBBBBBBBBBBBBBBBBBBBB33BBBBBBBBB3BBBBBBBBBB3BBBBBBBBBBBBBBBB7BBB9BBBBBBBBBBBBBBBBBBB3BBBB79BBB,
512'hB3BBBB3BB3BBBBBBB3BBBBBB7BBB9B39BBB3BBBBBBBBBB3BBBB7BBBBBBBBBBBBBBBB7BBBBBBBBBBBB9BBBBBBBB3BBBBBBBBBBBB9BBBB3BBB7BBBBBBBBBBB7BBB,
512'h9B9BBBBBBBBBBBBBBBBBBBBBBBBBBBBBBBB9BBBBBBBBBBBBBBBBBBBBBBBBBBBBBBBBBBBBBBBBBBBBBB3BBBBBBBBBBBBBBBBBBBB9BBBBBBBBBBBBBBBBBBBBBBBB,
512'hBBBBBBBB9BBBBB9BB7BBBBB3BBBBBB3BBBBBBBBBBBBB7B9BBBBBB9BBBBB7BBBBBBBB3BBBB9BBB9BBBBBBBBB7BB9BBBBB7BBBBB3BBB3BBB7BBBBBBBB3BB3BBBBB,
512'hBBBBBBBB9BBB9BBBBBBBBBBBBBBBBBBBBBBB9BBB3BBBB3BBBB7BBBBB3BBBBBBBBBBBBB93BBB57BB9B9BBBBBBB5BBBBBBBBBBB3BBBBBBBB3BBBBBBBBBB9BBBBBB,
512'hB3BBBBBBBB7B93BBBBBB7B3BBBB3BBB5B9B9BBBBBBBBBB5B3BBB5BBBBBBBBBBB5BBB9BBBBBBB3BBBBBBBBBBBB7BBBB3BBBBBBBB9B9BB9B5B7BBBBBBBBBBBBBBB,
512'hBBBBBB9BBB3BBBBBBB3BBBBBBBBB9BBBBBBB9BB3BBB9BBB3BBBBBBBB73BBBBB3B9B9BBBBBBBB5BB9BBBBBBBBBBBBBBBBB77BBBBBBBBBBBBB9BBBBBBBBBBBBBBB,
512'hBBBBBBBBBB39BB3B3BBBBBBBB7B3BBBBBBBBBBBBBBBBBBBBBBBB9B9BBBBBBBBBBBBB3BB39BBBBBBBBBBBBB7BBBBBBBB7BBBBBBBBB3BBBBBBBB3BBBBBBBBBBBBB,
512'hBBBB37BBBBBBBBBBBBBBBBBBBBBBB7BB5BBBBB9BBBB9BBB9BBBBBBBBBB3BBBBBBBBBBBBBBBBBBBBBBBBBBBBBBBBBBBB3BBBBBBBBBB5BBBB9BB9BBBBBBBBBBBBB,
512'hBBBB3BBBBBBBBBBBBB3BBBB7BBBBB3BBB7BBBBBBBB3B3B973BBBBBBBBB7BB7B7B9BBBBBBB33BBBBBB9BBBBBB3BBBBB3BBBBBBBBBBBBBBBBBBBBBBB3BBBB3B5BB,
512'hBBBBBBB5BBBBBBBBB5BBBBBBBBBBBBBBBBBBBBBBBBBBBBBBBBB55BBBB9BBBBBBBBBBBBBBBBB9B9B3B3BBBBBBB3BBBBBBB9BBBBB77B9B7BBBBBBBBBB3BB3BBBB3,
512'hBBBBBBBBB3BB7BBBBBBBB7BBBBB7BBBBBBBBB7BBBBBBBB9BBBBBBBBBBB3BBBBBBBBB33BBBBBBBBBBBBBBBBBBBBBBBBBBBBBBBBB3BBBBBBBBBBB7BBBBBBBB3B9B,
512'hBBBBBBBBBBB3BBBBB7BBBBBBBBBBBBBBBBBB3BBB9BBB3BB9BB9BBBBBBB3BBBBBBBB333BBBBBB3BBBBBBBBBBBBBBBBBBB79BBBBBBBBBBBBBBBBBBBBBBB57BBBBB,
512'h5BBBBBB9BBB7BB7BBB3BBBBBBBBBBBBBBBBBBBBBB9BBBBBBB5BBBBBBBBBBBBBBBBBBBBB9BBBBB9BBBBBBBBBBBBBBBBBBBBBBBBB9BBB3BBB535BBBBBBBBBBBBBB,
512'hB3BBBBBBBB9BB3BBBB5BBBBBBBBBBB95BBBBBB7BBBBBB33BBBBBBBBBB9BBBBBBBBBBBBBBBBBBBBBB9BB59BBBBBBBBBBBB3BBB9BBBBBB9BBBBBBBBB5BBBBBBBBB,
512'hBBBB7BB9BB3BBBBBBBB3BBBB3BBBBBBBB7BBBBBBBBB7BBBBBB9BBBBBBBB9BBB3BBBBBBB9BB3BBBB7BBBBBB3BBBBBBBB7BBBBBBBBBBB3BBBBBBBBBBBBBBBBBBBB,
512'hB3BBB55BBBBBBBBBBBBBB9BBBB3BBBB35BBB9BBBBBBBBBBBB7BBBBBBBBBB9B5BBBB3BBBBBBBBBBBBBBBB7BBBBBBBBBBBBBBB9BBBBBBBBBBBBBBBBBBBBB33BBBB,
512'hB7BBBBBB3B7BBBBBBBBBBBBBBBBBBBBBBBBBBBBB3BBBBBBB59BBBBBBB5BBBBBBBBBBBBBBBBBBB39B3B73B9BB5BBBBBB3BBBBBBBBBBBBB5B9BBBBBBBBBBBBBBBB,
512'hBBBBBBBBBBBBBBBBB7B5BB39B9BBB5BBB3BBBBBBBBBBB3BB9BBBBBBBBBBBBBBBBBBBBBBBBBBBBBBB3BBBBBBBBBBBBBBBBBBBBBBBBBBBBBBBBBBB7B3BBBBBBB97,
512'hBBBBBBBBBBBBBBBBBBBBBBBBBBBBB9BBB9BBBBBBB3BBBBB7BB9BBBBBBBBBBBBBBBBBBBBBBBBBBBBBBBBBBB9BB7BB33BBBBBBBBB95B7BB39B9BBBBBB3BB7BBBB9,
512'hBBBBBBBBBBBBB3BBBBBBB3BBBB3BBBBBBBBBBBBBBBBBBBBBBB3BBBBBBBBB5B3B3BBBBBBBBBBBBBB9BBBBBB5BBBBBBBBBB33BBB3BBBB9B9BB9BBBBBBBBBBBBBBB,
512'hBBBBBB9BBBBBBBBBBBBBBBBBBBBBBBBB5B3BBBBBB3BBBBBBBBB3BB3BBBBB7BB9BBBB9BBBBBBBBBBBBBBBBBBBBB7BBBBBBBB99BBBBBBBB9BBBBBBBBBBBBBBBB9B,
512'hBBBBBBBBBBB9BBBB3BBBBB3BB37B53BBBBB7BBBBBBBB3BBBBBBBBBB3BBBBBBBB3BBBBBB5BBBBBBBBBBBBBBBBBBBBBBBB3BBBBBB5B33BBBBBBBBBBBBBBB7B9BBB,
512'h11111111111111111111111111111111111111111111111111111111111111111111111111111111111111111111111111111111111111111111111111111111,
