256'h0000000000000000000000000000000000000000000000000000000000000000,
256'h0000000000000000000000000000000000000000000000000000000000000000,
256'h0000000000000000000000000000000000000000000000000000000000000000,
256'h0000000000000000000000000000000000000000000000000000000000000000,
256'h0000000000000000000000000000000000000000000000000000000000000000,
256'h0000000000000000000000000000000000000000000000000000000000000000,
256'h0000000000000000000000000000000000000000000000000000000000000000,
256'h0000000000000000000000000000000000000000000000000000000000000000,
256'h0000000000000000000000000000000000000000000000000000000000000000,
256'h0000000000000000000000000000000000000000000000000000000000000000,
256'h0000000000000000000000000000000000000000000000000000000000000000,
256'h0000000000000000000000000000000000000000000000000000000000000000,
256'h0000000000000000000000000000000000000000000000000000000000000000,
256'h0000000000000000000000000000000000000000000000000000000000000000,
256'h0000000000000000000000000000000000000000000000000000000000000000,
256'h0000000000000000000000000000000000000000000000000000000000000000,
256'h0000000000000000000000000000000000000000000000000000000000000000,
256'h0000000000000000000000000000000000000000000000000000000000000000,
256'h0000000000000000000000000000000000000000000000000000000000000000,
256'h0000000000000000000000000000000000000000000000000000000000000000,
256'h0000000000000000000000000000000000000000000000000000000000000000,
256'h0000000000000000000000000000000000000000000000000000000000000000,
256'h0000000000000000000000000000000000000000000000000000000000000000,
256'h0000000000000000000000000000000000000000000000000000000000000000,
256'h0000000000000000000000000000000000000000000000000000000000000000,
256'h0000000000000000000000000000000000000000000000000000000000000000,
256'h0000000000000000000000000000000000000000000000000000000000000000,
256'h0000000000000000000000000000000000000000000000000000000000000000,
256'h0000000000000000000000000000000000000000000000000000000000000000,
256'h0000000000000000000000000000000000000000000000000000000000000000,
256'h0000000000000000000000000000000000000000000000000000000000000000,
256'h0000000000000000000000000000000000000000000000000000000000000000,
256'h0000000000000000000000000000000000000000000000000000000000000000,
256'h0000000000000000000000000000000000000000000000000000000000000000,
256'h0000000000000000000000000000000000000000000000000000000000000000,
256'h0000000000000000000000000000000000000000000000000000000000000000,
256'h0000000000000000000000000000000000000000000000000000000000000000,
256'h0000000000000000000000000000000000000000000000000000000000000000,
256'h0000000000000000000000000000000000000000000000000000000000000000,
256'h0000000000000000000000000000000000000000000000000000000000000000,
256'h0000000000000000000000000000000000000000000000000000000000000000,
256'h0000000000000000000000000000000000000000000000000000000000000000,
256'h0000000000000000000000000000000000000000000000000000000000000000,
256'h0000000000000000000000000000000000000000000000000000000000000000,
256'h0000000000000000000000000000000000000000000000000000000000000000,
256'h0000000000000000000000000000000000000000000000000000000000000000,
256'h0000000000000000000000000000000000000000000000000000000000000000,
256'h000000000000000000000000000A000000000000000000000000000000000000,
256'h00000000000000000000000000AAA00000000000000000000000000000000000,
256'h000000000000000000A000000AAEAA0000000000000000000000000000000000,
256'h08880000000000000AAA0000AAAEAAA00000000000000000000000000A000000,
256'h8CCC880000000000AAEAA000000E0000000000000000000000000000AAA00000,
256'hCCCBCC000000000AAAEAAA00000E000000000000000000000000000AAEAA0000,
256'hCCCBCB800000000000E00000000E00000000000000000000000000AAAEAAA000,
256'hCCCBBBC88888888000E00000000800000000000000000000000008000E000000,
256'hBBBBBBBCCCCCCCC888E00000000C8800000000000000008888880C888E000000,
256'hBBBBBBBCCCCCCCCCCC888888888CCC0000000000008800CCCCCC8CCCCE000000,
256'hBBBBBBBCBCCCCCCCCCCCCCCCCCCCCC800888888888CC88CBCBCCCCBCC8888888,
256'h3BBBBBBCBCCCCBCCBCBCCBBCCBCCCCC88CCCCCCCCCCCCCCBCBBCBBBBCCCCCCCC,
256'hBBBBBBBBBCCBCBCCBCBCBBBCBBCCBCCCCCCBBCCBCBCCBBCBCBBCBBBBBCCCCCCC,
256'hBBBBBBBBB9BBBBBBBBBCBBBCBBCBBCCCCBCBBCBBCBCCBBBBCBBBBBBBBCCCCCCC,
256'h9BBBBB939BBBBBBBBBBCBBBCBBC9BBBCCBCBBCBBCBCBBBB7BBBBBBBBBCBCBCCC,
256'hBBBBBB9BBBBBBBBBBBBBBBBBBBBBBBBCCBCBBBBBBBBBBBBBBBB7BBB9BCBCBBCC,
256'hBBBBBBBB9BBBBBBBBBBBBBBBBBBBBBBCCBBBBBBBBBB3BBBBBBBBB3BBBB3BBBBB,
256'hBB3BB3BBBBBBBBBBBBBBBBBBBBBBBBB3BBBBBBBBBBBBBBBBB3BBBBBBBBBBB9BB,
256'hBBB3BBBBBBBBB3B9BBBBBBBB7BBBBBBBBBBBBBBBBBBBBBBBBBBBBBBBBBBBBBBB,
256'hBBBB9BBBB3BBBBBB3BBBBBBBBBBBBBB33BBBBBBBBBB9BBBB3BBBBBBBBBB3BBBB,
256'hBBBBB3BBBBBBBBBBBBBBBBBBBBBB7BBBB9BBBBBB7BB7BBBBBB7BBBBBBBBBBBB3,
256'hBBBB3BBBBBBBBB3BBBBBBBBB3BB3BBBB9BB3BB3BBBB9BBBBBBBBB3BBBB3BBBBB,
256'hB3BBBB3BBBBBBBBBBB3BBBBBBBBB3BBBBBBBBB9BB9BBBBBBBBBB33BBBBBBBBBB,
256'hBBBBB9BB7BBBBBBBBBBBBB3BB7BBBB3BBBBBBBBBBBBBBBBBBBBBBBB9B3BB3BBB,
256'hBBBBBBBBBBBBBBBBBBBBBBBBBBBBBBBBB3BBBBBBBBBBBBBBBB97BBBBBBBBBBBB,
256'hBB9BBB9BBB3BBBBBBBBBBBBBBB9BBBBBBBB7BBBBB7BBBBBBB93BBB3BBBBBBBB3,
256'hBB3BBBB3B7B3BBBBBBBBBBBBBBBBBBBBB7BBBBBBBB7BBBBB7BBBBBBBBBBBB9BB,
256'hBBBBBB9BBBBBBBBBB9BBBBBBBBBBB7BB93BBBBBB9BBBBBBBBBBBBBBBBBBBBBBB,
256'hBB9BBBBBB3BBBBBB3BBBBBBBBBBBB73BBBBBBBB9BBBBBBBBBBBB3BBBBBB3BBBB,
256'hBB3BBB9BBBBBBBBBBBBBBB9BBB7BBBBBBBBBBBBBBBB3B9B9B7BBBBBBBBBB7BBB,
256'hB33BBBB9BBBBBBBB3BB3BBBB9BBBBBBBBB3BBBBBBBBBBBBBBBBBBBBBBBBBBBBB,
256'hBBBBBBBBBBBBBBBBBBBBBBBBB9B3BBBBBB3BBBB3BBBBBBBB3BB37BBBBBBBBBBB,
256'hBBBBBBBBBBBBBBBBBBBB7BBBBBBBBBBBBBBBBBBB9BBBBBBB9BBBBBBBBBBBBBBB,
256'hBBBBBBBBBB339BBBBBBBBBBB9BBBBBBBBBBBBBB93BBBBBBB3BBBBBBBBBBBBBB3,
256'hBBBBBBBBBBBBBBBBBBBBBBBBBBBBBBBBBB5BBBBBBBBB3BBBBBBBBBBB3BBB3BBB,
256'hBBBB5BBBBBBBBBBBBB3BB3B3BB3BB37BBBBBBBB3B9BB5BBBBBBBBB9BBBB59BBB,
256'hBBBBBBBB933BBBB733BB5B3BB5BBBBBB3BBBBBBBBBBBBBBBBBBBBBBBBBBBBBBB,
256'h7BBB3BBBBBB3BB53B9B9B3BBBBBBBBBBBBB3BBB3BBBBBBBBBBBBBBBBBBB9BB3B,
256'hBBB9BBBBBBBBBBBBB3BBBBB9BB3BBBBB3BBBBB3BBB9BBBBBBBBBBBBB7BBBBBBB,
256'hBBBBBBBBBB3BBBBBBBBBBBBBBBB3BB33BBBBBBBBB5B5BBBBB33B7BBBBBBBBBBB,
256'h3BB7BBBBBBBBBBBBBBBBB7BBBB7BBBBBBBBBBBBBB3BBBB3BBBBBBBBBBBBBB5BB,
256'hBB7BBBBBBBBBBB79BB9BBB3BBB75BBBBBBBBBB9BB35B5BBBBB7B3B9BBBBBB5BB,
256'h9B3BB93BB9BBBB3BBBBBBBB7BBB597BB9B9B9BBBBBBBBBBBBBBBBBBBBBBBBB3B,
256'h9BBBBBBBBB39BB9B7BBBBBBBBB99BBB7BBBBBBBBBBB5BB9BBBBBBBBB9BBB3BBB,
256'h3BBBB9BBBBBBBBBBBBB9B3B7BBBBB37B7BBBB3BBBB9BBBBB9B3BBBBBBBBBBBBB,
256'hBBBBBBBBBBBBBBBBBB3BBBBBBB7BBBB9BBBBBB5B99B9BBB73BB9BB33BBBBBBBB,
256'hBB5BBB9BBB77BB9BBBBBBBB39BBB3BBB9BBBBBBBBBBBBB59BB3BBB5BB9BBB3BB,
256'h9BBB7BBB9BBBBBBBBBBBBBBBBBBBB3BBBBB5BBBBB3B9B9BB9BBBBBBBBBBB7BBB,
256'hBBBBBBBBBBB9BBBBB3BBBB3BBBBBBBBB3BBBBBBBBBB9BBBBB99BBB3BBBB3BBBB,
256'hBB3B3BBBBBBBB3BBBBBBBBBB3BBBBBBBBBB3BBBBBB5B3BBBBBBBBB9BBBBBBBB3,
256'hBBBBBBBB3BBBBBBBBBBBBBB3BBBB7BBB9B9B3BBBBBBBBBBBB3BBBBBBBBBBBBBB,
256'hBB9BBBBBBBBB5BBBBBBBBBBBBB9BBBBBBBBBBBBBB5B5BBBBBBBBBBBBBBBBBBBB,
256'h1111111111111111111111111111111111111111111111111111111111111111,
