00000000000000000000000000000000000000000000000000000000000000000000000000000000000000000000000000000000000000000000000000000000
00000000000000000000000000000000000000000000000000000000000000000000000000000000000000000000000000000000000000000000000000000000
00000000000000000000000000000000000000000000000000000000000000000000000000000000000000000000000000000000000000000000000000000000
00000000000000000000000000000000000000000000000000000000000000000000000000000000000000000000000000000000000000000000000000000000
00000000000000000000000000000000000000000000000000000000000000000000000000000000000000000000000000000000000000000000000000000000
00000000000000000000000000000000000000000000000000000000000000000000000000000000000000000000000000000000000000000000000000000000
00000000000000000000000000000000000000000000000000000000000000000000000000000000000000000000000000000000000000000000000000000000
00000000000000000000000000000000000000000000000000000000000000000000000000000000000000000000000000000000000000000000000000000000
00000000000000000000000000000000000000000000000000000000000000000000000000000000000000000000000000000000000000000000000000000000
00000000000000000000000000000000000000000000000000000000000000000000000000000000000000000000000000000000000000000000000000000000
00000000000000000000000000000000000000000000000000000000000000000000000000000000000000000000000000000000000000000000000000000000
00000000000000000000000000000000000000000000000000000000000000000000000000000000000000000000000010100000000000000000000000000000
00000000000000000000000000000000000000000000000000000000000000000000000000000000000000000000101010101010000000000000000000000000
00000000000000000000000000000000000000000000000000000000000000000000000000000000000000001010101000101010101000000000000000000000
00000000000000000000000000000000000010100000000000000000000000000000000000000000000010101010101000101010101010100000000000000000
00000000000000000000000000000000101010101010000000000000000000000000000000000000000000000000000000100000000000000000000000000000
00000000000000000000000000001010101000101010101000000000000000000000000000000000000000000000000000100000000000000000000000000000
00000000000000000000000010101010101000101010101010100000000000000000000000000000000000001000100000100000000010001000100010000000
00000000000000000000000000000000000000100000000000000000000000000000000000001000100010000100010010001000000001000100010001001000
00000000000000000000000000000000000000100000000000000000000000000000000000000100010001000011010001000100100001000100001100110100
00000000000000000000000000000000000000100000000000000000000010001000100010000011010000110011001101000100010001000100001100110100
00000000000000000000000000000000000010001000100010001000100001000100010001000011010000110011001101000011010001000100001100110011
00000000000000000000000000000000100001000100010001000100010001000100010001000011010000110011001100110011010000110011001100110011
00000000000000000000000000000000010000110100010000110011010001000011010001000011001100111011001100110011001100110011001100110011
00000000000010001000000010001000010000110011010000110011010001000011010000110011001100110011001100110011001100110011001100110011
00000000100001000100100001000100010000110011010000110011010000110011010000110011001100110011001100110011001100110011001110111011
10001000010001000100010001000100001100110011001100110011010000110011001100110011001110110011001100110011001100110011001100111011
01000100010001000100010000110011001110110011001100110011001100110011001100110011001100110011001100110011001100110011001100110011
00110011010000110100010000110011101110110011001100111011001100110011001100110011001100110011001100111011001100110011001100110011
00110011010000110100001100110011001100110011101100110011001100110011001110110011101100110011001100110011001100110011001100110011
00110011001100110011001100110011001100110011001100110011001100110011001100110011001100110011001100110011001100110011001100110011
00110011101100111011001100110011001110110011001100110011001100110011001100110011001110110011001100110011001100110011001100110011
00110011001100110011101100110011001100111011101100110011001100110011001100110011001100110011001100110011001100110011001100111001
00111011001100110011001100110011001100110011101100110011001100110011101100110011001100110011101100110011101110110011001100111001
00110011001100110011001100110011001100110011001100110011001100110011001100110011001100110011101100110011101100110011001100110011
00110011001100110011001110110011101100110011001100111011001100110011001100110011001100110011001100110011101100110011001100110011
00110011001100110011001110110011101100110011001100110011001100110011001100111001101100110011001110110011001100110011001100110011
00110011001100110011001100111011001110010011100100110011001100110011001100111001001100110011001100110011001100111011001100110011
10010011001100110011101100111011001100110011100110111011001110010011001100110011001100110011001100110011001100110011001100111001
10010011001100110011001100110011001100110011001100110011001110010011001100110011001100110011001100110011001100110011001100110011
00110011001100110011001100110011001100110011001100110011101100110011001100110011001100110011001110011001001100110011001100110011
00110011001100110011001100110011101100110011001100110011001100110011001100110011001100110011001100111001001100110011001100111001
00110011001100111001001100110011101100110011001100110011100100110011001100110011101100110011001100110011101100110011001100111001
00110011101110110011001100110011001100110011001100111011001100110011001100110011101100110011001100110011101110110011001100110011
00110011001100110011001100110011001100110011001100111011001100110011001100110011001100110011001100110011001100111001001100110011
00111001100100110011001110110011001100110011001100110011001100111001100100110011001110110011001100110011001100110011001100110011
00110011001100110011001100110011001110110011001110010011001110110011001100111001001100111011001100110011001100110011001100110011
00110011001100110011101100110011001110111011001100110011001110110011001100110011001100110011001100110011001100110011001100110011
00110011001100110011101100110011001100110011001100110011100100110011001100110011001100110011001100110011001100110011001101110011
00110011001101110111001100110011001100110011001101110011001100110011001100110011001100110011001100110011001110110011001100111011
10110011001100111011101100110011001100110011001100110011001100110011001100110011001100110011001100110011001110110111001100110011
10110011001100110011001100110011001100110011001100110011001100110011001100111011001100110011001100110011001100110011001100110011
00111001001110010011001100110011101100111011001100110011001100111001001100110011001100110011001100110011001100110011001101110011
00111001001100110011101110110011001100111011001100110011001100110011001100110011001100110011001100111011001100110011001100110011
00111011101100110011001110110011001100110011001100110011001100111011100100110011001100110011001100111011001100110011001100110011
00110011101100110011001100110011001100110011001110110011001100110011001100110011001100110011001100111011001100110011001100110011
00110011001100110011001100110011011100110011011110110011101100110011001100110011001100110011010101010011001100110011001100110011
00111011101100110011001101010101011100110011001100110011001100110011001100110011001100110011001101010011001100110011101100110011
00111011101100110011001100110101010110011001001100110011001100110101001100110011101110110011001100110011001100110011101100111001
00110011011100110011001100110011011100111001001100110011001100111011001100110111100100110011001100110011001100110011001110010011
10010011001100110011001100110011001100111011001100110011001100111011001110010111100100110011001100110011001100110011001100110011
00110011001101011011001100110011001110110011001110010011001100110011001110010011001110010011001110010011001100110011001100110011
00110011001100110011001100110011001110110011001100110011001100110011001100110011001100110011001110010011001100110011001100110011
00010001000100010001000100010001000100010001000100010001000100010001000100010001000100010001000100010001000100010001000100010001
