00000000000000000000000000000000000000000000000000000000000000000000000000000000000000000000000000000000000000000000000000000000
00000000000000000000000000000000000000000000000000000000000000000000000000000000000000000000000000000000000000000000000000000000
00000000000000000000000000000000000000000000000000000000000000000000000000000000000000000000000000000000000000000000000000000000
00000000000000000000000000000000000000000000000000000000000000000000000000000000000000000000000000000000000000000000000000000000
00000000000000000000000000000000000000000000000000000000000000000000000000000000000000000000000000000000000000000000000000000000
00000000000000000000000000000000000000000000000000000000000000000000000000000000000000000000000000000000000000000000000000000000
00000000000000000000000000000000000000000000000000000000000000000000000000000000000000000000000000000000000000000000000000000000
00000000000000000000000000000000000000000000000000000000000000000000000000000000000000000000000000000000000000000000000000000000
00000000000000000000000000000000000000000000000000000000000000000000000000000000000000000000000000000000000000000000000000000000
00000000000000000000000000000000000000000000000000000000000000000000000000000000000000000000000000000000000000000000000000000000
00000000000000000000000000000000000000000000000000000000000000000000000000000000000000000000000000000000000000000000000000000000
00000000000000000000000000000000000000000000000000000000000000000000000000000000000000000000000000000000000000000000000000000000
00000000000000000000000000000000000000000000000000000000000000000000000000000000000000000000000000000000000000000000000000000000
00000000000000000000000000000000000000000000000000000000000000000000000000000000000000000000000000000000000000000000000000000000
00001000100000000000000000000000000000000000000000000000000000000000000000000000000000000000000000000000000000000000000000000000
00000100010000000000000000000000000000000000000000000000000000000000000000000000000000000000000000000000000000000000000000000000
10000100010010000000000000000000000000000000000000000000000000000000000000000000000000000000000000000000000000000000000000000000
01000100010001000000100000000000000000000000000000000000000000000000000000000000000000000000000000000000000000000000000000000000
00110100010001001000010000001000100010001000000000000000000000000000000000000000000010100000000000000000000000000000000000000000
00110100001101000100010010000100010001000100100000000000000000000000000000000000101010101010000000000000000000000000000000000000
00110011001101000100010001000100010001000100010010000000000000000000000000001010101000101010101000000000000000000000100010001000
00110011001101000011010001000100001101000100010001001000000000000000000010101010101000101010101010100000000010001000010001000100
00110011001100110011010001000100001101000100010001000100000000000000000000000000000000100000000000000000100001000100010001000100
00110011001100110011001100110011001100110100010001000100100000000000000000000000000000100000000000001000010000110011010000110100
00110011001100110011001100110011101100110011001101000100010010001000100000000000000000100000000010000100010000110011001100110011
00110011001100110011001100110011001100110011001100110100010001000100010010001000100010001000100001000100001100110011001100110011
00110011001100110011001100110011001100110011101110110100010001000100010001000100010001000100010001000100001100110011001100110011
00110011001100110011001100110011001100110011001100110011010001000100010001000100010000110100010001000100001100110011001100110011
00110011101100110011001100110011001100110011001100110011001101000011010001000011010000110011010001000011001100110011101100110011
00110011101100111011101100110011001100110011001100110011001100110011010001000011010000110011010000110011001100110011001100110011
00110011001100111011101100110011001100110011001100110011001100110011001100110011010000110011001100110011001100110011001100110011
00110011001100110011001100111011001100110011001100111011001100110011101100110011001100110011001100110011001100110011001100110011
00110011001100110011001100110011001100110011001100110011100100110011001100110011001110110011100100110011001110010011001100110011
00110011001100110011001100110011001100110011001100110011001100110011001100110011001100110011001100110011001100110011001100110011
00110011001100110011001100110011001100110011001110111011001100110011001100110011001100110011001100110011001100111011101100110011
00110011101100110011001110010011001100110011001100111011001110110011001100110011001100110011001100110011001100110011101100110011
00110011101100110011001110010011001110010011001100110011001100110011001100110011001100110011001100110011001110110011001100110011
00110011001110111001001100110011001100110011001100110011001100110011001100110011001100110011001100110011001110110011001100110011
00110011001100110011001100110011001100110011001100110011001100110011001100110011001100110011001100110011001100110011100100110011
00110011001100110011001100110011101100110011001100110011001100111011001100110011101100110011001100110011100110010011001100110011
00110011001100110011001100110011001100110011001100110011101110111011001100110011001100110011001100110011001100110011001100110011
00111011001100110011001100110011001100110011001100110011001110110011001110011011101100110011001110110011001100110011001100110011
10110011001100110011001100110011001100110011001100110011001100110011101100110011001100110011001110110011001100111011101100110011
10111011001100111011101100110011001100110011001100110011001100110011001100110011001100111011001100110011001100110011101100110011
00110011001100110011101110110011001100110011001100110011001100111001001100111011001110110011001100110011001100111001001100110011
00110011001100110011001110110011001110110011001100110011001100111001001100111011001110110011001100110011001100110011001100110011
00110011001100110011100110111011001100110011001100110011001100111001100100111011001100110011001100110011001100110011001100110011
00110011001110010011001100110011001100110011001100111011001100110011001100110011001100110011101100110011100100110011001100110011
00110011001110110011001100110011001100110011001100111011001100110011001100111001100100110011101110011001100100110011101100110011
00111001001100110011001100110011001100110011100100110011001100110011001101110111001100110011001110011001001100110011001100110011
00110011001100110011001100110011001100110011101100110011001100110011001100111011001100110011001101110111001100110011001100110011
10011001001100111011101100110011001110111011001100110011101100110011001100110011101100110011001100110111001100110011001100110011
10011001001100110011101110010011001100110011011100110011101100110011001100110011001100110011001100110011001100110011001100110011
10010011001100110011001110110011001100110011011100110011100100110011001100110011001100110011001100110011001100111011001100110011
01110011011100110011001100110011101110110011001100110011001100110011001100110011001100110011001110010011001100110011001100110011
00110011001100110011001100110011001100110011001100110011001100110011001100110011001110110011001100110011001100110011001100110011
00110011011100110011001101010011101100110011001100110011001100111001100110110011001100110011101100110011001100110011001100110011
00110011001100110011001100110011001100110011001100110011001100110011100101110011001100110011101100110011001100110011001100110011
00110011001100110011001110111011001100110011100100110011001100110011001100110011001100110011001100110011001100110111011100110011
10011001011100110011001100111011001100110011001100110011101100110011001100110011001100110011001100110011001100110011001100110011
00110011011100110011001100110011001110010011001100110011001101010011101100110011001100110011001100110011001100110011001100110011
00110011001110111011001101110011011100110011001100110011001100110011001100110011001100110011001100110011001100110011001100110011
00110011001100111011001100110011001100110011001100110011001100110011001100110011001100110011001100110011001100110011001100110011
00010001000100010001000100010001000100010001000100010001000100010001000100010001000100010001000100010001000100010001000100010001
