0000000000000000000000000000000000000000000000000000000000000000000000000000000000000000000000000000000000000000000000000000000000000000000000000000000000000000000000000000000000000000000000000000000000000000000000000000000000000000000000000000000000000000
0000000000000000000000000000000000000000000000000000000000000000000000000000000000000000000000000000000000000000000000000000000000000000000000000000000000000000000000000000000000000000000000000000000000000000000000000000000000000000000000000000000000000000
0000000000000000000000000000000000000000000000000000000000000000000000000000000000000000000000000000000000000000000000000000000000000000000000000000000000000000000000000000000000000000000000000000000000000000000000000000000000000000000000000000000000000000
0000000000000000000000000000000000000000000000000000000000000000000000000000000000000000000000000000000000000000000000000000000000000000000000000000000000000000000000000000000000000000000000000000000000000000000000000000000000000000000000000000000000000000
0000000000000000000000000000000000000000000000000000000000000000000000000000000000000000000000000000000000000000000000000000000000000000000000000000000000000000000000000000000000000000000000000000000000000000000000000000000000000000000000000000000000000000
0000000000000000000000000000000000000000000000000000000000000000000000000000000000000000000000000000000000000000000000000000000000000000000000000000000000000000000000000000000000000000000000000000000000000000000000000000000000000000000000000000000080000000
0000000000000000000000000000000000000000000000000000000000000000000000000000000000000000000000000000000000000000000000000000000000000000000000000000000000000000000000000000000000000000000000000000000000000000000000000000000000000000000000000000000040000000
0000000000000000000000000000000000000000000000000000000000000000000000000000000000000000000000000000000000000000000000000000000000000000000000000000000000000000000000000000000000000000000000000000000000000000000000000000000000000000000000000000000848000000
00000000000000000000000000000000000000000000000000000000000000000000000000000000000000000000000000000000000000000000000000000000000000000000000000000000000000000000000000000000000000000000000000000000000000000000000000000000A0000000000000000000008444800000
0000000000000000000000000000000000000000000000000000000000000000000000000000000000000000000000000000000000000000000000000000000000000000000000000000000000000000000000000000000000000000000000000000000000000000000000000000000AAA000000000000000000004444488888
000000000000000000000000000000000000000000000000000000000000000000000000000000000000000000000000000000000000000000000000000000000000000000000000000000000000000000000000000000000000000000000000000000000000000000000000000000AA2AA00000000000000000884444444444
00000000000000000000000000000000000000000000000000000000000000000000000000000000000000000000000000000000000000000000000000000000000000000000000000000000000000000000000000000000000000000000000000000000000000000000000000000AAA2AAA0000000000000888444434444434
00000000000000000000000000000000000000000000000000000000000000000000000000000000000000000000A0000000000000000000000000000000000000000000000000000000000000000000000000000000000000000000000000000000000000000000000000000000000020000000000000000444444333433434
0000000000000000000000000000000000000000000000000000000000000000000000000000000000000A00000AAA000000000000000000000000000000000000A00000000000000000000000000000000000000000000000000000000000000000000080000000000000000000000020000000000888888444443333433433
000000000000000000000000000000000000000000000000000000000000000000000000000000000000AAA000AA2AA0000000000000000000000000000000000AAA0000000000000000000000000000000000000000000000000000000000000888888840000000000088888800000020000000008444444444433333333433
000000000000000000000000000000000000A0000000000000000000000000000000000000000000000AA2AA0AAA2AAA00000000000000000000000000000000AA2AA00000000000000000A000000000000000000000000000000008888888808444444448800000000044444488880088888888884444444344433333333333
00000000000000000000000000000000000AAA000000000000000000000000000000A0000000A00000AAA2AAA00020000000000888000000000000008000000AAA2AAA000000000000000AAA00000000000000000000000000000004444444484444444444400080008844444344440844444444444444333334333333333333
0000000000000000000000000000000000AA2AA0000000000000000000000000000AAA00000AAA0000000200000020000000888444880000080000004800000000200000000000000000AA2AA000000000000000000000000000088343444444343433434448884808443444334443844444434343344433333333B333333333
000000000000000000000000000000000AAA2AAA00000A00000000000000000000AA2AA000AA2AA00000020088002888888844443444888884080008448880000020008880000008000AAA2AAA000000000000000000000008000443334443433334334334444444844434433344434444434343333434333333333333333333
00000000000000000000000000000000000020000000AAA000000000000000000AAA2AAA0AAA2AAA00000288448884444444444433444444448488843344400000200844480000048000002000000000000000000000000084888333334443333334333334444343434433333344434344334333333333333333333333333333
0000000000000000000000000000000000002000000AA2AA000000000000000000002000000020000000084444444444444434433343434443444444334348888888844444008884400000200000000000000000000000084444433333343333333333333443334343343B33334343333433433333333333333333BB333BB333
000000000000000000000000000000000000200000AAA2AAA0808000000000000000200000002000008884443444434443443433333343344343444433434444444444344488444448800820088088088880000000008884444443333333333333333333333333334334333333333333333333333333333B33333333333B3333
000000000000000000000000000008000008800000000200084840000000000000002000000028880844444434343343434433333333433433434444334344444433443344444434444884880448448444480880000044444433433333333333333333333B3333334333333333333333BBB333333333333B3333333333333333
0000000000000000000000000008840000844000000882080434488000088000000088888888844484344444343333434333BBB333333333333344333343444444334433433434334444434484344444443484488888444333334333333333333333333333333B334B3B333333BB3333BB3333333BB333333333333333333333
00000000000000000000000000044488884448888884428484343448888440888888444444444444433343433333333333B33333333333333333433333B33434433343333333343343443344433444334434434444444433333343333333333333B33B33333BB33333BB333333B333333B33333333B33333333B333333333333
00000000000000000000000808834444443334444444484444343444444448444444434443444434433343333333333333B33333333333BB3333333333333333433343333333343333343344433444334434434444443433333BB3333333333333333333B33BB333BB3BB3BB33333333333333333333B333333B333333333333
000000000000000000000084844334443333334444434433343434444344444443343344434344334333433333333333333333333333333B3B333333333333333333333333333333333433333333343333333334434333333333B33B333333B333333333333333333B3333333333B33333333333333333333333333333333333
0000000000000000088880444443334433333334444344333334344443434344333433444333333333B3BB3333333333333333B333333333333333333333333333333333333333333333333333333333333333343343333333333333333333333333B333333B3333333333BB3333B3333333333B333333333333B33333333333
000888888888800004444844444333443333333444433333333333343333434433343343333333B3333333333333333B3333333333B333333B333B33333333333333333333333333333BB3333333BB33333333333333333333333BB33333333333B33333333B33333333333B333333333333333B333333333333B333333BB333
0004444444444888834344434443334333333334443333333BB33334333333443333333333B33BB3333333333333333B33333333333333333B333B3333333333B3333333B33333333B33B33333333B333333333333333333333333B3333333333BB3BB3B3333BBBB3333333B3333333333333333333333333333333333333333
88844444444434444343434334333333333333333333333333B333333333333BB3BB3333333BB333333333333333333BB33333333333333BB33333B333333333333333333333333B33333333333333333B333333333333333333B3333333333333333B3333333BB333333B33333B33B333333333333333333333333333333333
444343444434344443434333333333333333333333333333333333B3333333B3333B3333333BBBB3333333B33333333B33333333333BB3333333333333B333333B3333333333333B33333333333333333B333333BB3333333B33333333B3B333333333333BB33333333B3B33333BB333333333333333B33B3333B33333333333
34434343333334443333333B333333333333333993333333333333B333333333933333333333B3B3333333B3333333333333333B3333B3933399B3333BB3333333333B33B3393B333333B3B3333333B3B33999333333333B33BB33333333B33333333333333B33333B393B993333B33B3333BBBB333333333B33B33333333333
3343333333333433333333333333333333B3333B3333933333B3BB3333333333933393333333B333BB3393333333333333399333333333333399B333333339333933933333339B33333B333333333333B3339333B33333333333333333333BB33333333333333333333333333333333993333B333333B333BB333333333BB333
334BB3B33333333339333333BB3333333933333333333333333333333333333333333333333333333B3B399333333333333393B333333339333333B3B3B333333933333B33B3333333333333333B333333333333333BBB333B3333BB333339B393399B33333B3333333333333333333393B33333399333333333333333B3B333
3333B3BB333333333933B3393B333333B993B33333333333333BBB39933333333333399933BB3933333B33939333339333333333333393333333BBB33333333B3333333333B33333B3333399333B3333393333333333BBB3333333333333333393339B33393333333333BB333333333333BB339333333333333333BB33333333
3333333B333333333333BB33333399933393333993333333BB33B3339993333339933399333333333333333B3993333333993333339333393333333B3339933B333333333333B333333333333B33333933333B39399333333393333333333333BB3333333393333939333B33333333333333BB3333BB33933339333333333333
33333333333333333333B3333333B9993B333333933333333B33933339933B3333933333333333333393339993933333333333339993333333333333333393333333333333333333333333333333933933333B39333333333333333B333333333B333BB33393333339333B333333333339333393333B33333333333333333333
33333333B33393393333333333333B3333333BBB33333B33BB3333333333333333933333333333B3333333333333333333333333B933333333333333B3333333333339B3B333333333333333B333333333B333333333333333333B3B333333333B33333B3333333333333B3333339933333333333333BB333333333333333333
33333333393393333B333BB3333333333333333333B99333333333333333333333933333333333B3333B333333333333BB3993333B39393B33333333B33333333BB333B3B3333393333333333333B3333333333B3333333B33333333333333333333333B333333333333333333333333333333333B333B3333333333333B9333
3399333339333333333333333333333333333333333B9339333333333993339333333333B3333333333B33339333333333399339933339333333333B3333333333B33333B333B3333333333333333333333333BB3333333B33BB333333333333333BB33333333B3B333333333333333333333333333333333333333333333333
3BB333333333333399BB33333333333333BBB3333933B3333333333393933333333333333333333333399333333B3333333333333933393333333333333333B3333333333399B399333333393333333333393333B333333333333333333333B3B3333BB333333333333B33333333333333333333333B33333333333333333333
33B3B9333393333333333333333939333333B33BB3333333333333333333B3933333333333333333333393333B9B333393333933333333333339933339333BB333333333333333393333333933333333333933333333333333333333333333B3B33333B333333333333B3333333333BB333333333333333B3333BB3333333333
333339BB339333333B333333333BB333BB339333B333333333933333339333333BB33333333333333339333399333B3333333933333BB33B33339933333333B33333BB33933B3933BBB33333B3333993333333333333333333333333BBB3333333393B333333333333999333333B333B3333333B33333339333BBBB33B33B333
3339333B33333333B33333333333B3333B33933339333333333333333333333333B3B3333B333333333B33333933333333333333933333333339993B33393B3333BB3B33333333333333333333B3339333333333333333333333333333B33B33333933333333333333B9333333333333333333333333B3393333B3B33B933B33
33333333B3333333B33333333333333333333333333BB3B33B333333339333333333B333B3333333333333333333333393393B33333333333399333333B33B33333B3333BB33333333339333BB33B393333B993393333333333333BB33333B3333333333399333BBBBB3333333333333333BB333333333333933333333333333
33B933339933333333BB333333333333333333333333B3B3333333333333BB33339933333333B333333B33333333333333333333B33333333339B33333333333333333333333333333339333333333333B333333B33333399333399B3333333333333333B33B33333B33333333333333333333339333333333333333B3333333
33B933333333333333333339333333933333B333333333333333333333333B33333333333333333333333333333B333333333333B33333BB3393333333333333B33333333B33BBB3333333333399B3B3333333333333333393333393333333B333333333B3333B3333333B33333BB3333333333B3B333993B3333333B3333333
33B933333333333333333333333333333333B33933333333333333333B3B333393B333393333333333333333333333933333333B333333333393333773BB3B33333333333B333733339B3333333333B333333333B333333333333393333333B33333333333333333333BB3333333B933333333333333339BB333333333333333
33933333933333333333B33333333333333333393B333B3333333333333333373B33933333B3337333B33333333333333339333333333333333BBBB37333333333333333B3BB33993393333333333373333333333333BB3733333393333333333B333393333333333333B333B37333393333333B33333333333333333BB33333
33BB7733333B3333BB333379333333B333333993333333333333BB3333333BB3333333333333337333333333333333333333399333333333333333333333337333333333373773393333333733337779333333333333333333333393333333333333B33333333333333333333B7333333B3333333333333333333BB333333333
33BB3333333333333B333333BB33333333333B933333333333333B33337333B33333333333333333333333333933333337333333333B33333333377333333393333B3333B33B333BB3333333333333B933333BB33333333333B33B333333B3333333B33333333333333333333B333B7B333373333BB33333333333B993333333
333333B3333333333333333333373333333333333333B93333333333333333773339933333B3333333333333B3993993333333373333339933333333333993BB333333333393333337737333333333333B933333333333BB33B3333333333333333993333333333B333993333B33333B3333333333373373333993333B333333
3333337799933B3393B33333333333333333333333B333333339333333B333373333333333BB3337333333333BB33773393333333333933333333333333B33BB3333333337333BB33333B3333333B93BB3B333333333333933333393333337333333933333B3373333339B333333333333333393B33377733333933333333333
339333373BB3333933333933373773333333337933B333B7733933333333333333333BB333333333333333333933B33B33333333B9933333B333B333333B333B3333333333333333333733333B33733333333333333333933333333333333333333BB333333B3333333377B333393B33333333933333BBBB3393333337333333
33333B3333B333393333333993333B333333337933333333339933333333333333333993333399333333333BB3333333337333333B3333333333333733333773333B3333333333337737993933337333333333333333339933333333333333337333B333333B33333333333333BB3733333333337333333B33333BB337333333
3337333333333333333333339333333333333337333335333333333333333333355333933333393B333333B7B3333B7333333333355333B3933BB333333B3333997733333B7733333733355B7339B3333333333333B333333333393333B33773B3333733333377339B333333333333333333339333333933B333333333333333
3373373333333339733333393BB33333333777373BB33B333733333333333333333333373333333333B333B333333B733333333333599333337353B533733333333BB3333333333739333353B393333333B3B533333333333333333553B33373B3333333333377333333333399933B333B3333733333BB3B3335533333333333
3373333333373339933393B933333333333379353337933333B33333333333333333333379933393BB3333333B333B3333333B9B33933333B37753B3339333733333B33333333B3333933333B33357993393B33333339333333333393333355553333333333333333333333B933BB33353B33733333333333333533333333333
33333337339B3333933933BBBB333333333B533B3337333333B333333333BB3393973B33733B33933B9933333B3333333933333333733333933333333B3333353333333933333393333333BBBB339333339333333333933399339333733333335993933933B33B3333339B3553B3333353733333333993393333333393333333
33333337333B3333533333773BB3333333337333377B3933333333339933BBB333373333333BB393B3333393B993333333335333337333BB33333333333B3337333333333333333BB33333B33B3993333933333373B9333333333333333333333333333333B393333333BB3B5333BB3333333337B33393393333B93393333333
35533333933733333333333BB3B3333B33333333B33B33BB3333333339B39933333333333333B33333333B97B39733333B3333333373333333333333333BBB333333377333333333B333333333339333333B333333B33339333B33393377333333333B3B333333333333B33B339333333333339BBB3333333B39333333333333
33333333333733333333333333333333333333333333333333333333333333333333333333333333333333B373333333333333333333333333333333333333333333337333333333B333333333333333333333333333333933333339333733333333333333333333333333333393333333333333333333333333333333333333
1111111111111111111111111111111111111111111111111111111111111111111111111111111111111111111111111111111111111111111111111111111111111111111111111111111111111111111111111111111111111111111111111111111111111111111111111111111111111111111111111111111111111111
