00000000000000000000000000000000000000000000000000000000000000000000000000000000000000000000000000000000000000000000000000000000
00000000000000000000000000000000000000000000000000000000000000000000000000000000000000000000000000000000000000000000000000000000
00000000000000000000000000000000000000000000000000000000000000000000000000000000000000000000000000000000000000000000000000000000
00000000000000000000000000000000000000000000000000000000000000000000000000000000000000000000000000000000000000000000000000000000
00000000000000000000000000000000000000000000000000000000000000000000000000000000000000000000000000000000000000000000000000000000
00000000000000000000000000000000000000000000000000000000000000000000000000000000000000000000000000000000000000000000000000000000
00000000000000000000000000000000000000000000000000000000000000000000000000000000000000000000000000000000000000000000000000000000
00000000000000000000000000000000000000000000000000000000000000000000000000000000000000000000000000000000000000000000000000000000
00000000000000000000000000000000000000000000000000000000000000000000000000000000000000000000000000000000000000000000000000000000
00000000000000000000000000000000000000000000000000000000000000000000000000000000000000000000000000000000000000000000000000000000
00000000000000000000000000000000000000000000000000000000000000000000000000000000000000000000000000000000000000000000000000000000
00000000000000000000000000000000000000000000000000000000000000000000000000000000000000000000000000000000000000000000000000000000
00000000000000000000000000000000000000000000000000000000000000000000000000000000000000000000000000000000000000000000000000000000
00000000000000000000000000000000000000000000000000000000000000000000000000000000000000000000000000000000000000000000000000000000
00000000000000000000000000000000000000000000000000000000000000000000000000000000000000000000000000000000000000000000000000000000
00000000000000000000000000000000000000000000000000000000000000000000000000000000000000000000000000000000000000000000000000000000
00000000000000000000000000000000000000000000000000000000000000000000000000000000000000000000000000000000000000000000000000000000
00000000000010001000100010001000100010000000000000000000000000000000000000000000000000000000000000000000000000000000000000000000
00001000100001000100010001000100010001001000100000000000000000000000000000000000000000000000000000000000000000000000000010100000
10000100010001000100010001000011010001000100010000000000000000000000000000000000000000000000000000000000000000000000101010101010
01000100010000110100001100110011001101000011010010000000000000000000000000000000100000000000000000000000000000001010101000101010
01000100010000110100001100110011001100110011010001001000000000000000000000000000010010000000000000000000000010101010101000101010
01000100010000110011001100110011001100110011010001000100100010001000100010001000010001001000100010001000100010000000000000100000
01000100001100110011001100110011001110110011010001000011010001000100010001000100001101000100010001000100010001000000000000100000
00110011001100110011001100110011001110110011001101000011001101000011010001000011001100110011010001000100010001001000100000100000
00110011001100110011001100110011001100110011001101000011001101000011001100110011001100110011010000110100010000110100010010000000
00110011001100110011001100110011001100110011001100110011001101000011001100110011001100110011001100110100010000110100010001001000
00110011001100110011101110110011001100110011001100110011001100110011001100110011101100110011001100110011001100110100010001000100
00110011001100111011101100110011001100110011001100110011001100110011001100110011001100111011001100110011001100110100010001000100
00110011001100110011101100110011001100110011001100111011001110111011001100110011001100110011001100110011001100110011001101000100
10110011001100110011001100110011001100110011101100111011001100110011001100110011001100110011001100110011001100110011001101000011
00110011001100110011001100110011001110111011001100110011001100110011001100110011001100111011001100110011001100110011001100110011
00110011001100110011001110111001001100110011001100110011001100110011001100111001100100110011001100111011001100110011001100110011
00110011001100110011001100110011001100110011001110110011001100110011001100110011100100111001001100110011101100110011001110011001
00110011001100110011001100110011001100110011001110110011001100110011001100110011001100110011001100110011101100110011001110110011
00110011001100110011001100110011001100110011001100110011001100110011001100110011001100110011001100110011101110110011001110110011
00110011100100110011001100111001100100110011001100110011001100110011001100110011001100110011001100110011001100111011001100110011
00110011101100110011001110010011001100110011001100110011001100110011001100110011101110111001100100110011001100110011001100110011
00110011101100110011001100110011001100110011001100110011001100110011001100110011001100111001100100110011001100110011001100110011
00110011001100110011001100110011001100110011001100110011001100110011001100110011001100110011100100110011001100111011001100110011
10011001001100110011001100110011001100110011001100110011001100110011001100110011001100110011001100110011001100110011001100110011
00111001001100110011001110010011001100111011101100110011001100110011100100110011001100110011001100110011101100110011001100110011
00110011001100110011001110010011001100110011101100110011001100110011100100110011001100110011001100110011001110010011001100110011
00110011001100110011100100110011001100110011100100110011001100110011100100110011001100110011001100111011001100111011100100110011
00110011001100110011101100110011100110010011100100110011001100111011001100110011001100110011101100110011001100110011100100110011
00110011001100110011001100110011001100111011101100110011001100110011001100111001100100110011001100110011001100110011001100110011
00110011001110110011001100110011001100111011101110110011001100110011001100110011100100110011001100110011001100110011001100111011
00111011101100110011001100110011101100110011001100110011001100110011001100110011001100110011101100110011001100110011001100110011
00110011100110011001001100110011001100110011001100110011001100111011001100110011101100110011100100110011001100110011001100111011
00110011001101111001001100110011100100110011001100110011001100111011001100111001101100110011100100110011001100110011001100111011
00110011001100110011001100110011001100110011001100110011001100110011001110110011100100110011001100110011001100110011100110010011
00110011001100110011001100110011001100110011001100110111001100110011001110110011001101110011011100110011011101110011001110010011
00110011001110011001011100110011100110010011100101110011001100110011001100110011100110010011001100110011001100110011011101111011
10010011001100111001011100110011001110010011101101110011001100110011001100110011001100110011001100110011001100110111001100111011
00110011001100110011001100110011001110011001001110110011001100110011001110011011101100110011001100110011001100110111001100111011
00111001100100110011001100110011001100110011001100110011001100111011101110111001101100110011011101110011001100110011001100110011
00110011001100110011001110110011001100110011001100110011001100111001001100110011101110110011101101110011011100110011001100110011
00110101001110010011001100110011001110110011001110010011001100111001001100111011001100110011010101010011001100110011001100110011
00110011001100110011011100110011001100111001001110010011001110011001001100110011001100110011001101010011100100110011001100110011
00110011001100110111001100110011001100110011001100110011001100110011001100111011001100110011100100110011001100110011001100111011
00110011001100110011011100110011001110110011001100110011001100110011101100110011001100110011100100110011001100110011001100110011
01010011001100110011001100110011001110111011001100111001100100111011101101110011001100111001100100110011001110110011101110110011
00110011001100110011001100110011001100110011001100110011100100110011101101110011001100110011001100110011001100110011001100110011
00010001000100010001000100010001000100010001000100010001000100010001000100010001000100010001000100010001000100010001000100010001
