00000000000000000000000000000000000000000000000000000000000000000000000000000000000000000000000000000000000000000000000000000000
00000000000000000000000000000000000000000000000000000000000000000000000000000000000000000000000000000000000000000000000000000000
00000000000000000000000000000000000000000000000000000000000000000000000000000000000000000000000000000000000000000000000000000000
00000000000000000000000000000000000000000000000000000000000000000000000000000000000000000000000000000000000000000000000000000000
00000000000000000000000000000000000000000000000000000000000000000000000000000000000000000000000000000000000000000000000000000000
00000000000000000000000000000000000000000000000000000000000000000000000000000000000000000000000000000000000000000000000000000000
00000000000000000000000000000000000000000000000000000000000000000000000000000000000000000000000000000000000000000000000000000000
00000000000000000000000000000000000000000000000000000000000000000000000000000000000000000000000000000000000000000000000000000000
00000000000000000000000000000000000000000000000000000000000000000000000000000000000000000000000000000000000000000000000000000000
00000000000000000000000000000000000000000000000000000000000000000000000000000000000000000000000000000000000000000000000000000000
00000000000000000000000000000000000000000000000000000000000000000000000000000000000000000000000000000000000000001010000000000000
00000000000000000000000000000000000000000000000000000000000000000000000000000000000000000000000000000000000010101010101000000000
00000000000000000000000000000000000000000000000000000000000000000000000000000000000000000000000000000000101010100010101010100000
00000000000000000000000000000000000000000000000000000000000000000000000000000000000000000000000000001010101010100010101010101010
00000000000000000000000000000000000000000000000000000000000000000000000000000000000000000000000000000000000000000010000000000000
00000000000000000000000000000000000000001000100000000000000000000000000000000000000000000000000000000000000000000010000000000000
00000000000000000000000000000000000000000100010010001000100000000000000000000000000000000000000000000000000000000010000000000000
00000000000000000000000000000000100010000100010001000100010010001000100010001000100010001000100010001000100010001000100010000000
00000000000000000000100010001000010001000011010001000100001101000100010001000100010001000100010001000100010001000100010001001000
00000000000010001000010001000100001101000011001101000100001100110100010001000100010001000100010001000100010000110100010001000100
00000000100001000100001100110011001100110011001101000100001100110100010001000100010001000100010000110100001100110100010000110100
10001000010001000100001100110011001100111011001101000011001100110100010001000100001100110100001100110100001100110100001100110100
01000100001101000011001100110011001100111011001100110011001100110100001100110011001100110100001100110100001100110100001100110011
01000011001100110011001100110011001100110011001100110011001100110011001100110011001100110011001100110011001100110011001100110011
01000011001100110011001110111011001100110011101100110011001100110011001100110011001100110011001100110011001100111011001100110011
00110011001100110011001100110011001110110011001100110011001100110011001100110011001100110011001100110011001100111011001100110011
00110011001100110011001100110011001110110011001100110011001100110011001100110011001100110011001100110011001100110011001100110011
00110011001100110011001100110011001100110011001100110011001110111011001100110011001100110011001100110011101110110011001100110011
00111011101100110011001110111011001100110011001100110011001100110011001110110011001100110011001100110011001100110011001100110011
00110011001100110011001100110011001100110011001100110011001100110011001100110011001100111011001100110011001100110011001100110011
00110011001100110011001100110011101100110011001100110011001100110011001100110011001100110011001100110011001100110011001100110011
00110011001100110011001100110011101100110011101110110011001100110011001100110011001100110011001100110011001100110011001100110011
00110011001100110011001100110011001100111001100110110011001100110011001100110011001100110011100110111011001100110011001100110011
00110011001100110011001100110011001100110011001100110011001100110011001100110011001100110011100100111011001100111011001100110011
00110011001100110011001100110011101100110011001100110011001100110011001100110011001100110011101100110011001100110011001100110011
00110011001100110011001100110011001100110011001110011001001100110011001100110011001110110011101100110011001100110011001100110011
00110011001100111011100100110011100110010011100100110011001100110011001100110011001110110011001100110011001100110011001100110011
00110011001100111011100100110011001100110011001100110011001100110011001100110011001100110011101100110011001100110011001100111011
00111011001100110011001100110011001100110011001100110011001100110011001100110011001100110011101100110011001100110011001100110011
00111011001100110011001100110011100110010011001100110011001100110011001100110011001100111011101100111001001100110011001100110011
00110011001100110011001100111001001100110011001100110011001100111001001100110011001100110011100100110011100100110011001100110011
00110011001100110011001100111001001100110011001100110011001100111001001100110011001100110011001100110011001100110011001100110011
10110011001110010011001100110011001110110011001100110011001100110011001100110011101110010011001100110011001100110011001100111011
10110011001100110011101100110011001100111011001100110011001110110011001100110011001100110011001100110011001100110011001110010011
00110011101100110011001100110011001100110011001110111011001100110011001100110011001100110011001100111011101100110011001100110011
00110011001100110011100100110011001100110011001100110011001100110011100100110011101100110011001100110011001100110011001100110011
00110011001100110011001100111011101100110011001100110011001100110011100100110011101100110011001100110011001100110011001100110011
00110011001110011001001100110011001100110011100100110011001110110011001100110011101110010011101110110011101100110011001100110011
00110011001100111001001100110011001100110011001100110011001100110011001101110111011110011011101100110011001110110011001100110011
00111011001100110011001100110011001100110011001100110011001100110011001100110011001100111011001100110011001110111011001100110011
00110011001100110111001100110011011101110011100110011001001100110011001110110011001100110011001100110011001100111011101100110011
10010011001100110111001100110011001101110111001100111001001100110011101110110011001100111011001100110011001100111011001100110011
01110011001100110011101100110011001100110011001100110011001100110011101100110011001100110011001100110011001100110011001100110011
00110011001100110011001100110011001100110011001100110011001100110011001100110011001100110011001100111001001100110011001110110111
10010011001100110011001100110011001100110011001100110011001100110011001100110011001100110011001100111001001100110011001100111011
10010011001100110011001100110011001100110011001100110011001100110011001100110011001100111001001100110011001100110011001100110011
10110011001100110011001100110011001101110011001100110011001100110011001110010011001100110011001100111011001100110011001100110011
00110011001100110111011100110011001100110011001100110011001100110011001100110011001110010011001110011001001100110011001100110011
00110011100100110011011100111011101100110011001100110011101100110011001100110111001100110011001100110011011100110011001100110011
01011001100100110011001100110011101101010011101100110011001100110011001100110111001100110011001100111011101100111011001100110011
00110011001100110011001100111011101100110011001100110011101100110011001100110011001100110011001100110011001100110011001100110011
00110011010101010011001100110011101100110011100100110011010100110011001100110011001100110011001101110011001101010011001100110011
00110011001101010011001100110011001100110011001100110011010100110011001100110011001100110011001101110011001100110011001100110011
00010001000100010001000100010001000100010001000100010001000100010001000100010001000100010001000100010001000100010001000100010001
