00000000000000000000000000000000000000000000000000000000000000000000000000000000000000000000000000000000000000000000000000000000
00000000000000000000000000000000000000000000000000000000000000000000000000000000000000000000000000000000000000000000000000000000
00000000000000000000000000000000000000000000000000000000000000000000000000000000000000000000000000000000000000000000000000000000
00000000000000000000000000000000000000000000000000000000000000000000000000000000000000000000000000000000000000000000000000000000
00000000000000000000000000000000000000000000000000000000000000000000000000000000000000000000000000000000000000000000000000000000
00000000000000000000000000000000000000000000000000000000000000000000000000000000000000000000000000000000000000000000000000000000
00000000000000000000000000000000000000000000000000000000000000000000000000000000000000000000000000000000000000000000000000000000
00000000000000000000000000000000000000000000000000000000000000000000000000000000000000000000000000000000000000000000000000000000
00000000000000000000000000000000000000000000000000000000000000000000000000000000000000000000000000000000000000000000000000000000
00000000000000000000000000000000000000000000000000000000000000000000000000000000000000000000000000000000000000000000000000000000
00000000000000000000000000000000000000000000000000000000000000000000000000000000000000000000000000000000000000000000000000000000
00000000000000000000000000000000000000000000000000000000000000000000000000000000000000000000000000000000000000000000000000000000
00000000000000000000000000000000000000000000000000000000000000000000000000000000000000000000000000000000000000000000000000000000
00000000000000000000000000000000000000000000000000000000000000000000000000000000000000000000000000000000000000000000000000000000
00000000000000000000000000000000000000000000000000000000000000000000000000000000000000000000000000000000000000000000000000000000
00000000000000000000000000000000000000000000000000000000000000000000000000000000000000000000000000000000000000000000000000000000
00000000000000000000000000000000000000000000000000000000000000000000000000000000000000000000000000000000000000000000000000000000
00000000000000000000000000000000000000000000000000000000000000000000000000000000000000000000000000000000000000000000000000000000
00000000000000000000000000000000000000000000000000000000000000000000000000000000000000000000000000000000000000000000000000000000
00000000000000000000000000000000000000000000000000000000000000000000000000000000000000000000000000000000000000000000000000000000
00000000000000000000000000000000000000000000000000000000000000000000000000000000000000000000000000000000000000000000000000000000
00000000000000000000000000000000000000000000000000000000000000000000000000000000000000000000000000000000000000000000000000000000
00000000000000000000000000000000000000000000000000000000000000000000000000000000000000000000000000000000000000000000000000000000
00000000000000000000000000000000000000000000000000000000000000000000000000000000000000000000000000000000000000000000000000000000
00000000000000000000000000000000000000000000000000000000000000000000000000000000000000000000000000000000000000000000000000000000
00000000000000000000000000000000000000000000000000000000000000000000000000000000000000000000000000000000000000000000000000000000
00000000000000000000000000000000000000000000000000000000000000000000000000000000000000000000000000000000000000000000000000000000
00000000000000000000000000000000000000000000000000000000000000000000000000000000000000000000000000000000000000000000000000000000
00000000000000000000000000001000100010001000100000000000000000000000000000000000000000000000000000000000000000000000000000000000
10001000100010001000100010000100010001000100010010001000000000000000000000000000000000000000000000000000000000000000000000000000
01000100010001000100010001000100010000110100010001000100100010001000100010000000000000000000000000000000000000000000000000001000
01000100010000110100001101000100010000110100001101000100010001000100010001001000100010001000000010001000000000000000100010000100
01000100010000110100001100110100001100110011001101000100010001000100010001000100010001000100100001000100100010001000010001000100
00110100001100110100001100110100001100110011001101000100010000110100001101000011010000110011010001000100010001000100010001000100
00110011001100110011001110111011001100110011001101000100001100110100001100110011001100110011010000110011001101000100010001000011
00110011001100110011001100111011001100111011001100110011001100110011001100110011001100110011010000110011001101000011001101000011
00110011001100110011001100110011001100111011101100110011001100110011001100110011001100110011010000110011001101000011001100110011
00110011001100110011001100110011001100110011001100110011001100110011001110010011001100111011010000110011001100110011001100111011
00110011001100110011001100110011001100110011001110110011001100110011001100110011001100110011001100110011001100110011001100111011
00110011001100110011001100110011001100110011001100111011100110010011100100110011001100110011001110110011001100111001001100110011
00110011001100110011001100110011001100110011001100111011100100110011100100110011001110110011001100110011001100110011101100110011
00110011001110011001001100110011001100110011001100110011001100110011101100110011001110110011001100110011001100110011101100110011
00110011001100110011001100110011001100110011001100110011001100110011001100110011001100110011001100110011001100110011001100110011
00110011001100110011001100110011001100111011001100110011001100110011001100110011001110110011001100110011001100110011001100110011
00110011001100110011001100110011001100110011001100110011001100110011001110110011001110110011001100110011001100111001001100110011
00111011101100110011001100110011101100110011001100110011001100110011001110110011101110010011001100110011001100110011001110110011
00110011001100110011001100110011001100111011001110110011001100110011001100110011001100110011001100110011001100110011001110110011
00111001100100110011001100110011101100111011001100110011001100110011001100110011001100110011001110110011001100110011001100110011
00111001100100110011001100110011101101110111001100110011001100110011100100110011100100110011001101110011001100110011101100110011
10111001001100110011001100110011101101110011001100110011001100110011001100110011100100110011101101110011001100110011001100110011
10110011100110011001101110110011101110110011001100110011001100111011101100111011101100110011001110110011001100110011001100110011
00110011001110010011100110110011001100110011001100110011001100110011001100110011001100110011001100110011001100110011001100111001
00110011001100110011001100110011001100110111011100110011101100110011001100110011001100111011001100110011001100110011001100110011
00111001001100110011001100111011001100110011011100110011001110010011001100110011001100110011001100110011001100110011101100110011
00110011001100110011001110010011001100110011001100110011001100110011100100110011001110110011001100111011101100111011101100110011
01110011001100110011001110011001001100110011001100110011011100110011001100110011001110110011001100110011001110110011001100110011
00110011101110111011001100111001001110111011001101010101001100110011101110110011001100110011001100111011101100110011001100110011
01010011001100110011001101010011001100111011100100110011001100110011001110110011001100110011001100110011001100111001100100110011
01010011001100111001001100110011001100110011100100110011001100110011010110110011011100110011100100110011001100110011100110010011
00110011001100110011001100110011101100111011001100110011001100110011010100110011001101010101001100110011001101110011101110010011
00111011001100110011001100110011001100110011001100110011001110010011001100110011101110110101001100110111001100110011001110110011
00111011001110110011001101110111001100110011001101110011001100110011001100110011001110110011001100110011001100110011001100110011
00110011001100110011001100110111001100110011001100110011001100110011001100110011001100110011001100110011001100110011001100110011
00010001000100010001000100010001000100010001000100010001000100010001000100010001000100010001000100010001000100010001000100010001
