00000000000000000000000000000000000000000000000000000000000000000000000000000000000000000000000000000000000000000000000000000000
00000000000000000000000000000000000000000000000000000000000000000000000000000000000000000000000000000000000000000000000000000000
00000000000000000000000000000000000000000000000000000000000000000000000000000000000000000000000000000000000000000000000000000000
00000000000000000000000000000000000000000000000000000000000000000000000000000000000000000000000000000000000000000000000000000000
00000000000000000000000000000000000000000000000000000000000000000000000000000000000000000000000000000000000000000000000000000000
00000000000000000000000000000000000000000000000000000000000000000000000000000000000000000000000000000000000000000000000000000000
00000000000000000000000000000000000000000000000000000000000000000000000000000000000000000000000000000000000000000000000000000000
00000000000000000000000000000000000000000000000000000000000000000000000000000000000000000000000000000000000000000000000000000000
00000000000000000000000000000000000000000000000000000000000000000000000000000000000000000000000000000000000000000000000000000000
00000000000000000000000000000000000000000000000000000000000000000000000000000000000000000000000000000000000000000000000000000000
00000000000000000000000000000000000000000000000000000000000000000000000000000000000000000000000000000000000000000000000000000000
00000000000000000000000000000000000000000000000000000000000000000000000000000000000000000000000000000000000000000000000000000000
00000000000000000000000000000000000000000000000000000000000000000000000000000000000000000000000000000000000000000000000000000000
00000000000000000000000000000000000000000000000000000000000000000000000000000000000000000000000000000000000000000000000000000000
00000000000000000000000000000000000000000000000000000000000000000000000000000000000000000000000000000000000000000000000000000000
00000000000000000000000000000000000000000000000000000000000000000000000000000000000000000000000000000000000000000000000000000000
00000000000000000000000000000000000000000000000000000000000000000000000000000000000000000000000000000000000000000000000000000000
00000000000000000000000000000000000000000000000000000000000000000000000000000000000000000000000000000000000000000000000000000000
00000000000000000000000000000000000000000000000000000000000000000000000000000000000000000000000000000000000000000000000000000000
00000000000000000000000000000000000000000000000010100000000000000000000000000000000000000000000000000000000000000000000000000000
00000000000000000000000000000000000000000000101010101010000000000000000000000000000000000000000000000000000000000000000000000000
00000000000000000000000010100000000000001010101000101010101000000000000000000000000000000000000000000000000000000000000000000000
00000000000000000000101010101010000010101010101000101010101010100000000000000000000000001010000000000000000000000000000000000000
00000000000000001010101000101010101000000000000000100000000000000000000000000000000010101010101000000000000000000000000000000000
00000000000010101010101000101010101010100000000000100000000000000000000000000000101010100010101010100000000000000000000000000000
00000000000000000000000000100000000000000000000000100000000000000000000000001010101010100010101010101010000000000000000000000000
00000000000000000000000000100000100010001000100010001000100010001000000000000000000000000010000000000000000000000000000000000000
00000000000000000000000000101000010001000100010001000100010001000100100010001000000000000010000000000000000000000000000000000000
00000000000000000000000010000100010001000100010000110100001100110100010001000100100010000010000000000000000000000000000000000000
00000000000010001000100001000100010000110100001100110100001100110100010001000100010001001000000010001000100010001000100010001000
10000000000001000100010001000100010000110100001100110100001100110100010001000100010001000100000001000100010001000100010001000100
01001000100001000100010001000011010000110100001100110100001100110011010000110011010000110100100001000100010000110100010000110100
01000100010001000011010001000011001100110011001100110011001100110011010000110011001100110100010001000011010000110100010000110100
00110100001101000011010000110011001100110011001100110011001100110011001100110011001100110100010001000011010000110100010000110100
00110100001100110011001100111001001100110011001100111011001100110011001100110011001100110100010001000011001100110100010000110100
00110011001100110011001110011001001100110011001100110011001100110011001100110011001100110011010000110011001100110011001100110011
00110011001100110011001100110011001100110011001100110011001100110011001100110011001100110011001100110011001100110011001100110011
00110011100100110011001100110011001100111011001100110011001100110011001100110011001100110011001100110011101100110011001100110011
00110011100100110011001100110011001100111011001100110011100100110011001100110011001100110011001100111001101100111011001100110011
00110011001100110011001100111001001100110011001100110011001100110011001100110011001100110011100100110011001100110011100100110011
00110011100100110011001110010011001100110011001100110011001100110011001100110011001100110011100100111011100100110011001100111011
00110011001100110011001100110011001100111011001100110011001100111011001100110011001100110011001100110011100100110011001100110011
00110011001100110011001100110011001100110011001100110011001110110011001100110011001100110011001100110011001100110011001100110011
00110011001100110011001100110011001100110011001110111011001100110011001100110011001100110011001100110011100100110011001100110011
00110011100110010011001100110011001100110011001100111011001100110011001100110011001100110011001100110011100100111011001100110011
00110011001110010011001100111011101100110011001100111001001100110011001100110011001100110011001100111011001100110011001100110011
00110011001100110011001100110011101100110011001100110011001100110011001100110011001100110011001100110011001100110011001100110011
00110011001100110011001100110011001100110011001100110011001100110011001110010011001100110011001100110011100100110011001100110011
00110011001100110011001100111001001100110011001100110011001101110011001110010011001100110011001100110011100100110011100110010011
00110011001100110011001100110011001110110011001100110011001100110011001100110011001100110011001100111011100100110011001100111011
00110011001100110111001100110011001110110011001110110011001100110011101101110111001100110011001100110011101110110011001100111011
00111001100110011001001100110011001100110111001100110011001100110011101100110111001100110011001100110011101110110011001100110011
00110011100100110011001100111001001100110011001100110011001100110011001100110011101110110011011101110011001110010011001100110111
00110011001100110011001100110011101100110011001110111011101100111001011110110111011110110011001100110011001110010011001100110111
00110011001100111001001100111001100100110011001110011011001100110111001100110011001100110011001100110011001100110011001100110011
00110011001100111001001100111011100100110011001100111001001100110011001100110011001100110011100110010011001100110011001100110111
00110011001100110011001100111011001100111001010100110011001100110011001100110011001100110011001110010011001100110011001100110011
00110011001100110011101101110011001110111001001100110011001100110011001100110011001100110011101100110011001100110011101100110011
00110011001100110011101100110011001100110011001100110011100110110011001100110011001100110011101100110011001100110011001100111011
00110011001100110011001100110011001110111011001110111011101110110011001100110011001101010011001100111001001110010011001100110011
00110011001100110011001100110011001100111011001100111011001100110011100100110011101110110011001100110011001100110011001100110011
00110011001100110011101100110011001110110111001100110011001100110011001110110011100101110011001100110011001100110011001100110011
00110011001100110011001100110011001100110011001100110011001100110011001100110011001101110011001100110011001100110011001100110011
00010001000100010001000100010001000100010001000100010001000100010001000100010001000100010001000100010001000100010001000100010001
