00000000000000000000000000000000000000000000000000000000000000000000000000000000000000000000000000000000000000000000000000000000
00000000000000000000000000000000000000000000000000000000000000000000000000000000000000000000000000000000000000000000000000000000
00000000000000000000000000000000000000000000000000000000000000000000000000000000000000000000000000000000000000000000000000000000
00000000000000000000000000000000000000000000000000000000000000000000000000000000000000000000000000000000000000000000000000000000
00000000000000000000000000000000000000000000000000000000000000000000000000000000000000000000000000000000000000000000000000000000
00000000000000000000000000000000000000000000000000000000000000000000000000000000000000000000000000000000000000000000000000000000
00000000000000000000000000000000000000000000000000000000000000000000000000000000000000000000000000000000000000000000000000000000
00000000000000000000000000000000000000000000000000000000000000000000000000000000000000000000000000000000000000000000000000000000
00000000000000000000000000000000000000000000000000000000000000000000000000000000000000000000000000000000000000000000000000000000
00000000000000000000000000000000000000000000000000000000000000000000000000000000000000000000000000000000000000000000000000000000
00000000000000000000000000000000000000000000000000000000000000000000000000000000000000000000000000000000000000000000000000000000
00000000000000000000000000000000000000000000000000000000000000000000000000000000000000000000000000000000000000000000000000000000
00000000000000000000000000000000000000000000000000000000000000000000000000000000000000000000000000000000000000000000000000000000
00000000000000000000000000000000000000000000000000000000000000000000000000000000000000000000000000000000000000000000000000000000
00000000000000000000000000000000000000000000000000000000000000000000000000000000000000000000000000000000000000000000000000000000
00000000000000000000000000000000000000000000000000000000000000000000000000000000000000000000000000000000000000000000000000000000
00000000000000000000000000000000000000000000000000000000000000000000000000000000000000000000000000000000000000000000000000000000
00000000000000000000000000000000000000000000101000000000000000000000000000000000000000000000000000000000000000000000000000000000
00000000000000000000000000000000000000001010101010100000000000000000000000000000000000000000000000000000000000000000000000000000
00000000000000000000000000000000000010101010001010101010000000000000000000000000000000000000000000000000000000000000000000000000
10100000000000000000000000000000101010101010001010101010101000000000000000000000000000000000000000000000000000000000000000000000
10101010000000000000000000000000000000000000001000000000000000000000000000000000000000000000000000000000000000000000000010001000
00000000000000000000000000000000000000000000001000000000000000000000100000000000100010000000000000000000000000001000100001000100
00000000000000000000000000000000000000000000001000000000000000000000010010001000010001001000000000000000000010000100010001000011
00000000000000000000000000000000000000000000100010000000000000001000010001000100010001000100100010001000100001000100010000110011
00000000000010001000100010001000100010000000010001000000000000000100010001000011010001000100010001000100010000110100001100110011
00000000100001000100010001000100010001001000010001001000100010000100010001000011010001000100001101000100010000110011001100110011
10001000010000110100010001000011010000110100010001000100010001000011010001000011010001000011001100110100010000110011001100110011
01000100010000110011010001000011010000110011001101000100001101000011001101000011001100110011001100110100001100110011001100110011
01000100001100110011010001000011010000110011001101000100001101000011001100110011001100110011001100110011001100110011001100110011
00110011001100110011001100110011010000110011001100110100001101000011001100110011101100110011001100110011001100110011001100110011
00110011001100110011001100110011001100110011001100110011001101000011001100110011101100110011001100110011001110110011001100110011
00110011101100110011001100110011001110010011001110110011001100110011001100110011001100110011001100110011001100110011001100111011
00110011001100110011001100110011001110010011001100110011001100110011100100110011100110010011001100110011001100110011001100110011
10110011001100110011001100110011001100110011001110110011001100110011100100110011001100110011001100110011001100110011001100110011
10110011001100110011001100110011001100110011001100110011001100110011001100110011001100110011001100110011001100110011001100110011
00110011001100110011001100110011001100110011001100110011001100110011001110110011001100110011001100110011100110010011001100110011
00110011001100110011001100110011001100110011001100110011001100110011001110111001100110011001001100110011001110011011001100110011
00111011001100110011001100110011101100110011001100110011001110010011001100110011100100111001100100110011001100110011001100110011
00110011001100110011001100110011001100110011001100110011001100110011001100110011001100110011100100110011001100110011001100110011
10111011001100110011001100110011001100111001001100110011001100110011001100110011001100110011001100110011001100110011001100110011
10110011001100110011001100110011100100110011001100110011001100110011001100110011001100110011001100111011001110111011001100110011
00110011001100110011001110110011100100110011001110111011001100110011001100110011001100110011001100110011100100111011001100111011
00110011001100110011101110110011001110110011001100110011001100110011001110010011001100110011001100110011100100110011001100110011
00110011001100111011001100110011001110110011001110110011001100110011001100110011001100111011001110111001001110110011001100110011
00110011101100110011001100111001001110110011001100110011001100110011100100111011001100110011001100110011001100110011001100110011
00110011001100111001001100110011001100110011001100110011001100110011001110110011001100110011001100110011001100110011001100110011
00110011001110110011001100110011001100110011001100110011001110011001101110110011001100110011001100110011001100110011001100110011
10111011001100110011101110110011001100110011001100110011001100111001001100110011001100110011011100110011001100110011001100110011
00110011001100110011001110110011001110110011001100110011001101110011001100111001001100110011001100110011001100110011001100111011
10111011001100111011101100110011001110110011001100110011001110011001001100110011001100110111001100110011001100110011001100110111
00111011001100110011001100110011001100110011001100110011001100110011001100110011001100110011101110110011001100110111001100110011
00111001100100110011001100110011001100110011001100110011001100110011001100110011101110110011001110110011011101110011001100111001
00110011001100111001001100110011001100110011001100110011001100110011001100111001100110110011001100111011101110110011001100110011
00110011001100110011001100110011011100110011001100110011001100110011001100110011101110111011001110111011001100111001011100110011
00110011001100111011001100110011001101110111001110011001001100110011001100110011001100111011001100110011001100110011011100111011
00110011001100110011001110011001011101111001100100110011001100110011100100110011100100110011001100110011001100110011001100110011
00110011001100111001001101111011001101110011100100111011001100110011001100111011101101110011001100110011001100111011101110110011
00110011001100110011001100110011001100110011001100110011001100110011001100110011101100110011001100110011101100110111001110110011
00111001001100110011001100110011001100110011001100110101001100110011001110111011011101110011001110011001101100110011001100110011
10111001001100111011001100110011001100110011001110110011001101110011001100111011001100110011001100111001001100110111011100111001
00110011001100111011001100110101001100110011001100110011001101111011001100110011001100110011001100110011001100111001011100110011
00110011001100111011001100110011001100110011001100110011001100110011001100110011001100110011001100110011001100110011001100110011
00010001000100010001000100010001000100010001000100010001000100010001000100010001000100010001000100010001000100010001000100010001
